....................................................................................................................................................................................................................
....................................................................................................................................................................................................................
....................................................................................................................................................................................................................
....................................................................................Y..Y............................................................................................................................
....................................................................................................................................................................................................................
......................C.........................................................BBBBBBBB...BBBC..............C...........BBB....BCCB........................................................DD......................
...........................................................................................................................................................................................DDD......................
................................................................................................................Y.........................................................................DDDD......................
.........................................................................................................................................................................................DDDDD......................
.P..............C...BCBCB.....................FG.........FG..................BCB..............B.....BB....C..C..C.....B..........BB......D..D..........DD..D............BBCB............DDDDDD......................
......................................FG......HI.........HI.............................................................................DD..DD........DDD..DD..........................DDDDDDD......................
........................Y...F.........HI....Y.HI...Y..Y..HI............................................Y..Y................Y.Y.........DDD..DDD......DDDD..DDD.....FG.......Y.Y....FG.DDDDDDDD......................
............................HI........HI......HI.........HI...........................................................................DDDD..DDDD....DDDDD..DDDD....HI..............HIDDDDDDDDD........D.............
AAAAAAAAAAAAAAAAAAAAAAAAAAAAAAAAAAAAAAAAAAAAAAAAAAAAAAAAAAAAAAAAAAAAA..AAAAAAAAAAAAAAA...AAAAAAAAAAAAAAAAAAAAAAAAAAAAAAAAAAAAAAAAAAAAAAAAAAAAAAAAAAAAAAAA..AAAAAAAAAAAAAAAAAAAAAAAAAAAAAAAAAAAAAAAAAAAAAAAAAAAAAAAAA